






            A            
          XXXXX          



XXXXX               XXXXX


            A            
          XXXXX          



XXXXX               XXXXX



XXXXXXXXXXXXXXXXXXXXXXXXX