OOOXOOOOOOOOOOOOOXOOXOOOO
OOXXOOXXOOOOOXOOXXOOXXOOX
OOOXOOOOOOOOOOOOOXOOOOOOO
OOOXOOOOOOOOOOOOOXOOOOOOO
OXOXOXOOOXOOOXOOOXXOXXXOO
OOOXOOOOOOOOOOOOOXOOOOOOO
OOOXOXXXXOOOOOOXXXXOOOOOO
OXOXOOOOOOOOOOOOOXOOOOOOO
OOOXOOOOOOOOOOOOOXOOOOOOO
OOOXOOOOXXOOOOOOXXOOOXOOO
OOOXOOOOOOOOOOOOOXOOOOOOO
XXOXOXOOOOOOOOOOOXXXOOXXO
OOOXOOOOOOOOOOOOOXOOOOOOO
OOOXOXOOOXOOOXOOOXOOOOOOO
OOOXOOOOOOOOOOOOOXOOOOOOO
OOOXOOOOOXOOOOOOOXOOOOOOO
XXOXOXOOXXOOOOXXOXXXOOXXO
OOOXOOXOOOOOOOOOOXOOOOOOO
OOOXOOOOOOOOOOOOOXOOOOOOO
OOOXOOOOOOOOOOOOOXOOOOOOO
OOOXOOOOOOOOOOOOOXOXXOOOO
OOOXOOOOOOOOOXOOXXOOOOOOO
XXOOXXOOXXOOOOXXOOXXOOXXO
OOOOOOOOOOOOXOOOOOOOOOOOO
XXXXXXXXXXXOOXXXXXXXXXXXX