OOOOOOOOOOOOOOOOOOOOXOOOO
OOXXOOXXOOOXXXOOXXOOXXOOX
OOOOOOOOOOOOOOOOOOOOOOOOO
OOOOOOOOOOOOOOOOOOOOOOOOO
OXOOOXOOOXOOOXOOOOXOXXXOO
OOOOOOOOOOOOOOOOOOOOOOOOO
OOOOOOXXXXOOOOOOXXXXOOOOO
OOOOOOOOOOOOOOOOOOOOOOOOO
OOOOOOOOOOXOOOOOOOOOOOOOO
OOOOXOOOXXXXOOOOXXOOOXOOO
OOOOOOOOOOOOOOOOOOOOOOOOO
XXOOXXOOOOOOOOOOOOXXOOXXO
OOOOOOOOOOOOOOOOOOOOOOOOO
OOOOOXOOOXOOOXOOOXOOOOOOO
OOOOOOOOOOOOOOOOOOOOOOOOO
OOOOOOOOOXOOOOOOOOOOOOOOO
XXOOXXOOXXXXOOXXOOXXOOXXO
OOOOOOXOOOOOOOOOOOOOOOOOO
OOOOOOOOOOOOOOOOOOOOOOOOO
OOOOOOOOOOOOOOOOOOOOOOOOO
OOOOOOOOOOOOOOOOOOOXXOOOO
OOOXOOOOOOOOOXOOXOOOOOOOO
XXOOXXOOXXXXOOXXOOXXOOXXO
OOOOOOOOOOOOOOOOOOOOOOOOO
XXXXXXXXXXXXXXXXXXXXXXXXX