OOOOOOOOOOOOOOOOOOOOXOOOO
OOXXOOXXOOOOOXOOXXOOXXOOX
OOOOOOOOOOOOOOOOOOOOOOOOO
OOOOOOOOOOOOOOOOOOOOOOOOO
OXOOOXOOOXOOOXOOOOXOXXXOO
OOOOOOOOOOOOOOOOOOOOOOOOO
OOOOOOXXXXOOOOOOXXXXOOOOO
OOOOOOOOOOOOOOOOOOOOOOOOO
OOOOOOOOOOXOOOOOOOOOOOOOO
OOOOXOOOXXXOOOOOXXOOOXOOO
OOOOOOOOOOOOOOOOOOOOOOOOO
XXOOXXOOOOOOOOOOOOXXOOXXO
OOOOOOOOOOOOOOOOOOOOOOOOO
OOOOOXOOOXOOOXOOOXOOOOOOO
OOOOOOOOOOOOOOOOOOOOOOOOO
OOOOOOOOOXOOOOOOOOOOOOOOO
XXOOXXOOXXXOOOXXOOXXOOXXO
OOOOOOXOOOOOOOOOOOOOOOOOO
OOOOOOOOOOOOOOOOOOOOOOOOO
OOOOOOOOOOOOOOOOOOOOOOOOO
OOOOOOOOOOOOOOOOOOOXXOOOO
OOOXOOOOOOOOOXOOXOOOOOOOO
XXOOXXOOXXXOOOXXOOXXOOXXO
OOOOOOOOOOOOXOOOOOOOOOOOO
XXXXXXXXXXXOXXXXXXXXXXXXX